WE ./assets/wall1.xpm
SO ./assets/wall2.xpm
NO ./assets/wall3.xpm
EA ./assets/wall4.xpm
F 254,90,0
C 50,94,255


111
101
111

 11111 
10011011
1011 101
10001001111
10N00000001
11000000001
10000001111
11101011
1111111


11111