WE ./assets/wall.xpm
SO ./assets/wall.xpm
NO ./assets/wall.xpm




























EA ./assets/wall.xpm
F 250,142,0
C 118,124,255


111111 
10011011
1011 101
10001001111
10000000001
1000W000001
10000001111
11101011
1111111 
