NO ./assets/wall.xpm
SO ./assets/wall.xpm
WE ./assets/wall.xpm
EA ./assets/wall.xpm
F 220,100,0
C 225,30,0

1111111111111111111111111
100000000E000000000010001
1111111111111111111111111
