NO ./assets/wall1.xpm
SO ./assets/wall2.xpm
WE ./assets/wall3.xpm
EA ./assets/wall4.xpm


1111111111111111111111111
1000000000000000000000001
100000000E000000000010001
1000000000000000000000001
1111111111111111111111111
