WE ./assets/wall1.xpm
SO ./assets/wall2.xpm
NO ./assets/wall3.xpm
EA ./assets/wall4.xpm
F 254,90,0
C 50,94,255

1111111111111111111111111
1000000000110000000000001
1011000001110000000000001
10010000000000000000000011111111111
111111111011000001110000000000001
100000000011000001110111111111111
11110111111111011100000010001
11110111111111011101010010001
11000000110101011100000010001
10000000000000000000000010001
100000N0000000001101010010001
11000001110101011111000000111
11110111 1110101 101111010001
11111111 1111111 111111111111